(116,107)
(142,97)
(150,84)
(44,100)
(119,119)
(158,41)
(115,119)
(148,94)
(94,17)
(89,57)
11111011a11101110111011111111110111111a1111111111111111101a1111111111111011111111111111100111111111110111111111010011111a10111111111011001111111111111a111111111
01110100a11011111111111111111111111111a1101111110011110111a1111111111111111111110111111011101111101011211202222210020222b20221221212222111101011011111a111101111
11111111a11111111101111111111101111111a0011111011111111111a1111011111010111110111111111110101101111020211222221222212022a22212122221212111100111101111a111111111
11111111a11111111111110101111011111101a1111111111010111111a1111111110111111111111110101111111111011122121221211222212200b12112222122022111111111111111a111111111
11011111a11011111101111111011111111202a1112122010111210210a2111011111110111111111101101111101111110012122122220122102120b02020221221121111101111111111a111111111
11011111a11111111111111111011212202222b2221210110222211112b1011111111111111111111111110111011111111112112222022202212222a12222212021122111111110111110a111111111
11100111a11111111111110101111202012111a2222220221122010222a2001111101111101111111011111011110111110120121102212220121111b21212022212212111110000111110a111111111
11111111a11101111111111111111222102212b2210022122221111122b1110110111111011001011111111111111111101102211222102222022122b21222022222121011111111010111a111111111
01111011a11111111101010111001102200012a1111102110111110210b0011111111111011110111111110111101011110122221222222122212222b11120122222221111111111111101a111111101
11111101a11011111111011100111121221210a1211212221012112222a1110111111111101111101111111111111001111101202222212122221222b22201121221111111111111011110a111111111
11101111a11011111111111110101121221122b2112211110120202220b1111111111111110101111110011011111111111102220122210202211210b22111102222220121111120022201b212122111
11111111a11101111110111111111212112212b1111212011212121212a2111111111101111111101111111111111111111121202222211211222222b12221222212122112012111222121a011012211
11111101a11111111111101110111122102221a2210220011211221112a1111111101111111101111111111111111011111111212212221102212121b11211210221222121221121201111b102120011
11111111a11101111111111111110221122112b2222112122121211210a1111111100110111111111111111111111111111122202222121022122202b20222122101120122020112210202b212221011
11111111a01010111011110111111022201022a2221212221212211021a2111111110110111111111111110110111111111121122222022122222222b12222010221012211111221112211a022211121
11011011a11101111110111110111122211121b2221121121001111212a1111111111111110111101101111111101111101101112122222221202122b20222221222122222121212012222b121211010
11110111a11110111111010111111220102112a2021212212021112102b0111111110111111111111111111110110111101111111111111111111111a11111111111111120102111202012a122100110
11111110a11111111111111111111122210211b1211121221111221001b1101110010111110010111011101011101111111001101111111101111111a11111110111112112121121011211b122111221
11111111a11111111001011101111212111001b1112210201022221122a2111111110101111101111111111111111111111101111111111111110111a11011111110112120221121201111a110121211
11101111a11101011111111011101202112211b1222212210221121211b2110011111111111111001111111111111111111111111110111111111111a11111111011110121211121221222a022202011
11111111aaaaaaaaaaaaaaaaaaaaa122022202b2211012122212222122baaaaaaaaaaaaaaaaaaaa11111111110111111111111111011111011111111a11111111011122202202212212022b212102221
1111011111111111111011100111a222211221a111122100110101011100101111101111101111a01111111111111101111111111101111110111111a11111111110121212112002202122b222221201
1111111111111111101111111111a021021112a121211112112222122222101111111111011111a11111111111111111111111111111111111111101a11111001011110220220220222212b002122021
1111111111110111111101111111a112121111a011212121021222022120111111111010111111a11110111111111111111011111111111101101110a11111111111021222112222222222b020122221
1111111110111011011111111111a222212210b112222222222211102222111101111111110111a10111111111110111111111111111111111101110a11111111110121222022211122222b212220221
1111111101111111110011111111a210112202a211120220212120121122111011111101101111a11110101111111011111101111010100101111011a01111110111121210011022212121a202010211
1110111101110110111011111101a121111222b002212221220220220111101111111111110111a11111110111111111111110111101111111111111a11111100110121222220212102021b222112221
1100001011111100111111001000a021120121b111222121202112212201111011011101111111a01101111111001011011111111110111010111101a01111111011110220222211212011b002212221
1111111110111111001111101111a112200222b010212100211221111211111011111111001110a01110011111111110110001111111011010011111a01111110011111020212222221200a222222100
1111111111110001101011111111a110012212b121002111022122011110110111011011111110a11111101111010111111100111110010100101110a00111100110101222221210012202b210122221
0111111111110111100101011111a221112220a101121120202021121202011111111001100110a10110111111111011100011111010101100110011a01101101111111210222111100222b010222220
1011011111111111111101101011a201122220b021020111211220112210111111111001110111a10111111110010111111111001101111011011111a11110111111111112212112222200b200002211
1011111111111110111010101011a122122212a101020222022021202001111101111111111111a11111011011111111011011101000111111111111a10101101111122120221222222211b122221211
0111111110110111111011111111a220100022b222200111111111012211110111101010001111a01111110011111111111101111111111111110111a01110101011110222111212221020b220220200
0111111111111110110101011111a020222212a011102211100221221221001101011101100111a11111101111111110100011110111110001001111a11111111100001020122220200022b121212221
1110011101011110001100110010a111100111a110011111001110010011101110101111111001a11111111101011111111011111111101101101101a00101111100011120012212102202b021022211
1101111111110011011111110001a101111011a111000111101111111001111010111011110111a11111111101101111111111111100111110110011a01011011111120220222202112222b122221200
0101000110111111111111110110a111111001a111111111111111101010111111101111111111a11111111111111110010111111101111111111111a11111101111012222212220010022b010202211
1010111111111101111101101001a011110101a111100011011101111001111111111111110001a00001011101011111110010111111100011111110a00111111111120022222102202220b222122211
1111011100111011111101111111a011111111a111111011011111110110001111111111001011a11111111110101111111010111111110111111111a11000110010101020122222022212b222020221
1111111111111111111011011001a101111011a101111110010101111110110111111011101111a01111011111010111000110100110110111110100a11101101111111120202220221220b220200020
1011111000110101111111110111a111110111a111110111111110111011010111101111111101a11111110111110001010111111110010111101101a10011010111110111120112110222a022222111
1111010101001101011111011010a111011111a110111111111011011001110111111111111111a11111111111110101111010111011011100111111a11011111011110211220101221012b120102121
1111110101011011111111111001a101111111a111110111011101111110010000101101111110a10011111111111111111111101111101100001111a11011111111111020020112210202b212121201
1110111111101111111110111110a011001111a111010101101111010111111110111111111111a10101111111100011111011111111000101001111a10011111101100022210001211121a101201000
1011100011111101100101011101a110111111a110111111110101111011110111011111010011a11111111111111111111110110011010111011111a10111111011110011110121210221a121002111
0111010101101010101011111111a011110111a011111101001101111111110111101111111111a10111111010101101111011101110110110011111a01110011110101001021211101020a202021011
1110000101111011111100111111a111111001a111101111111111111011111111111111112110b10111001200100122211101111110111110101101a11111101101111221111210110101b121102200
1010111111111111111101111011a111111110a011111100101110101011100111110111000020a02222021111122011022122111111111110011111a01101111101000001012012021102b111021121
1111010111111111111111000011a101111001a111100101100111111111011111111111102122b22101221202202000121102202011111000101011a11001111001111022202011102112a202200211
1111101111011111111110111111a111111111a101010011101111110110111100111011111221a00002102211111112212111211000111111111111a11110011111110102122200022202b221212021
1110110101111110001001111110a111110101a011111111110100111111111111111111111011a12112212121120222121111202110111111001111a10111111111110111111111111011a110110011
0010111111011110110101110101a101101111a101111111100111101111111101110110110111b22211202220212112222111222011111111111111a11110111100110011111011101111a111110011
1101111100001110101101101101a011110101a011111111101111111100111110110111111212b20020110101222221210202121111111010110000a11111111110100111101101111011a011110111
1010011110100110101111111111a100010101a111111111111110011111001111001110012111a10212211211210200001202021111011101010100a11011111011011111111101111111a011110111
1111111111111011111110111110a011110110a100111111110111111001110111100111101121b2baabbaaaabababbbbabbb1210111111011011011a11110110100101111011111111111a101111101
1111111111011111001111111111a111011111a111001110011111110111111111111101112121a0a2020001102221222112b1020011001111111101a10111010111011110101111011000a110111011
0011110011101111111110101111a110111111a010101111101011100111111111000111111020b1a2110211022110100210b0110111110110011111a01111110011011101110110101001a101111110
1110111110101001110111100111a101011101a111111001101101100111011110011010110111a2a2212012000100102220b2111001011111111001a10111111110111111011110110011a111111011
0110101011011011111011110011a111010111a111011110101101100101111011110111112212b2a1222121202002122112b2102011111101100111a11101101110001010110110110111a100110100
1111101111101110110111011111a011110111aaaaaaaaaaaaaaaaaaaaaaaaaaaaaaaaaaaabbbaa2b1111200202022122012b1102111111111100101a11111110111110110001111110101a110111111
1111010100101101001011110111a010111111111111111110110111111111111110011111010122b0222211210111121022a1200110111111101111a01111110100101111101111001110a111000101
1011111011111101001110111010a001111101101101101111010001010011101111110111222221a2212012011221202120b0102011110111110101a10111011011101011011111101110a011111011
1001101101010110111111011111a111111111111011111101101111111111000111111111202001a1201001020210212020a2121111111101111111a01111111101111111101001121221b220022021
1111110111110111111111111110a100110101111110111011111111110111111011011110122000a2212021121020021212a2012111111000111011a01101111110100011111112212112b102021220
1110110010011100110101111111a001001111100011111111111111111111111101111101122111b1220002111121022012b1001111011001000101a11111110101100101101001011200b122220111
0111111111011111111100111111a011111111010111001111111101111011111111101111202120b2002211211101001000b2212111011011010111a11110010110111111010012111220a221100221
1111101111011111111111110011a011010011111101111111101101111111110110110011112211b1112022121202122102b2202111111101010110a11010011101010111111102222212b110022110
1011110101101111111111110111a101111111110001111111101101110001111111111011221122b1111112120201200122a1122011001111111111a01101001101011111111110220110b210210010
1111111000011101001110111111a100111111011111111111001111111001110111101111101210b1010200221212011211b2001111100011111111a11110111111111001111100121110a212202111
1110011111111101010011111111a011011101111111111011111011110111111111101011002221b1022011201022122222b2112111011011111111a01101011111101110100101122210a220211021
1111101111100011110010101111a010110111010111101111011101111110001111111101212022b1021011121111222220a0122111111101011100a10111111011100111001111011221b011121221
0111111111100111100011011111a111111011100111111101111100111101111101111011020122a1021222212102120110b2120011111111100101a11011111111111101010112202100b111210021
1011001111010011111101111001a101111111101110101001111111101110011111101111122121a2012222111222112222b1202111001011111111a00011110111110011001112210111b212021110
1110101011110111111101111111a111111111011111111111101001110111111101111011211211a2120211020022002122a2111101111110000000a01111101111111111111101122202a021212221
1101111110011111000110011001a101111011111110111011110001110101101010100010222122a1210120120112112001abbaaaaaaaaaaaaaaaaaa11101111110111111000112111111b220111101
0111110011011110101110111101a000011101100111111111010101111111101110111001010112a011121021112012121221010011111011100011111010100110111110011001112010b122111110
1111111111100111000011111101a010111001111111011101111101011111110111011111000020b211101101102222212112221110101111011010101111111101101110111011002122a120121020
1111100111110111111101111010a111111100101011111010101100111010111110110011111101a111111111011111110111111111101110111101111110101011101111111112021122a110121011
1100110100111101101010010111a011100111001011001011101110010011111111111011101111a11111111110111011011100110111aaaaaaaaaaaaaaaaaaaaaaaaaaaaaaaaaababbbaa221200211
aaaaaaaaaaaaaaaaaaaaaaaaaaaaa111011011111110111101101110101111111111111111011111a11011111111010110111111010011a1111111111111001111110111111101111202010100112210
11011010111111110110111000101111111111000110101011010101011111111111010101101010a01011011111111101010010011101a1010111110111111111011111100111021112112201222111
10111011110111100010101011111101101111101011010111111010101110011110111110101111a01101101111111111111101111011a1100001110111100111111101101101111011012111101221
01110100101111111111011110111111111111011101110111111001101111101111101111111111a11010011100110110110110110111a1100011111110100110111011111111121022102100110101
11101011011101111111101011111110011111101111110111011111100011011110011101101100a00111011111111110111111100111a1111101101111101110111111111010121001222212021211
10111110011101100111111101101111111010111101111111011111111111111101000110011111a00101111111110110111111110110a1111111111101111111110001011011012021220010201111
01111111110111111111111100101111111011101111111111111111110111111111111011001101a11100110110111010010111001101a1110111011111101111110111111101112212200201011021
10111111111111111111111101111000101111111111010001011111110111011111111111101101a20112210220222221210111211012a1100101100111001110111101111011100021120221102121
11111110011110010111011001111111101110101111111111101101111111111111111110000000b21212112121212222112011212201a1110101011111111111111011011001012211001111022010
01110101111111101011110111110111101100111111111110001111110111111001111110110102b22111220012122222222102222202a1111011111110110011011111111110112210002012011111
10101111110010101111011011111111111111110111111101010111110111011010111101011102a10221010101110211001222212212a1111111011111111111100010101011101210221220121021
10101111110110111110110011100100111111111110100011111101111110111111100111111112b12211012221001202011211012220a1111111000111111110111000111101012122212221212110
11110101011101111011101110101111001100110111101011100110011011011111000101001111b12101012111212022202122111201a1111010011111011111111110111101122201112021222211
00101101111111110011100111111010111110100111011111010000111111110011111010110110b12111111211210121112120222112a1111101100010011110011111111101122202202122021101
11111101111110110000111101011001111111111111111101010111110011011011111101011101a10112020201201011002110110102a1110101101110111111110101111110111110101011000101
aaaaaaaaaaaaaaaaaaaaa011101111111111111111111111101101111011aaaaaaaaaaaaaaaaaaaba12011121200222221120211202101a0011011101111111011011111111011111110010111111111
11111110111111111111a101111111011111111111111011010011111111a1101111111111011111211202121200120010221210100201a1111101111111111110111111111111011011111011011111
11101111111111111011a111101010111011101111111111111111100111a1111110011101111112021101211212221112201211211101a0111111111111101101111110111011111111101110111011
11001011111011110011a111101111101111001111111111010101010111a1100101111101101112101122001122112011222022000102a1111110110111101111111011110111111110011111101111
00111010111111101111a111110111111011110110111011111111111010a1111111110111111111102112112000021212121010121222a1111101111011011001011111111101101111100111011001
11010001111011110111a101011011101110100111111111001100000001a1110111011101011011010202111102101022221111121011a1110011111101111111111101101111010111111111111110
01111110111101110111a111111111100011110101101010110111011111a0100110111111111011112110101022110212200122220010a1011010101110111111101111011011111110110111011110
10111111101011111111a111011011101100111110111011111011111010a1110111101111110102221221121101110102202011222211a0111111111111111011111011011111111111111111111101
11111111011111011111a111101011111101101011101101110011011101a0011110111101001112022121012011110112012111012201a1111111111101111111010011011111111111011111010011
11011111111110111011a111100111111011100110111011111111000111a1110000010111101111212021001221211202110221020120a1011111010111110110010111010001001100111100110101
11110011110101111111a011011110111110111110110111011100111111a0101100111010111101222212222121021222220221201022a1101111100111111101111110111011110111111111111101
11111110111011110100a110111101111100111110001110111100100100a1110011111001110001201221012022001022201201122111a0111111111111111111010110011100011011101111111110
11110000101111011111a110111111110011000101110001101101010101a0101111111111000012021112020001000112202221020222a1111111110111111111101101111011111111011011111110
11100100111111010111a111111101011111111111111101111110011101a0101111110110111101101212011122022201201102102001a0111101111111100011111111001110111011011101110001
11101110011111001001a100111001111111110011111111111111011011a0010111111111111110121122201121221011122011211021a1011011111110111010101111111110101111111100111111
10011111011101111111a011111110110111111111101110111111011011a1111100111011101012022122111112022022121112211200a1111011110011101111111111110001111111110111111011
11011110111110011111a111011110010011111111111111111011111100a1111100111111111111221120022021210111112100111220a1111011110111110101100111011111111111001101011111
11111111010111111111a100111111111111000110111010111110101011a1111111011110001112210112002110220202002202212021a1111111000111100011001100111111111111110111011111
11101101111111010111a111101011111110111011111111111011010011a1110100111110111011102220101200012102120112102221a0111110110110101011010110111101110111001110001111
10111111110111011101a000111111011101111000111011010110011010a1111111111111111112102220022002112110021101001110a1001110111101011011101011111111011111111010111111
11111111111100111111aaaaaaaaaaaaaaaaaaaaaaaaaaaaaaaaaaaaaaaaa1100111110111111111112002211222012220220102221011a1111111111111111111111111101111101101011101111111
11101111101011111110111000101011111011111111111111110111110110110111101101011102212121222121102012112121221221a1011101111101101111111111101111101011111110000111
11111111110011011111111111110111110011110110010111110000001111101111111110010111112212021220012021010122210101a0101111111110101111111111100011110111011101100111
11111010111111111101111011111100110011011111111100111111111111011011110111101101110111111001010101001101110001a1011111111100110011111110111101011011110111110111
01111111101110111111111111110110111110111011111111111111011111111010111110001111111101111110001101111011111111a1111111111011011011000100110111111101111001111101
