0011111100010110101111111111111111110111101111110111111111111011111311110111111110101111111111111111100101111111011101110101111101111311111111111111111011111111
1111111011111001111100111111110111111111111111111010111101110010111311011111111111111110111111111111111111111111111111110111111111101311101011111111101111010011
1111111100110111011101101101011110010110111111101111101101111111011311011111111011101111100011111111111111111111111111110111111011100311110111000111110111111111
1111111111111111111101111011011011011101100111111011111111111110101311111111111011101111011111110111110111110011111111111101111111111311011111110011000110111011
1010010111011110011111111111111111011111110010101111111111101011111311100111111111010111101111101101011111110110011111110111101001011311101111111111011111111111
1111111111111101111101011100111011101101111111111111111110111101001311101111111110111111111111111110111110111111111001111111111011111311111111111111111101011111
1001111010111011011111111101011011111111111111100111111111101111110311111000010111111111111101001011011110111011100110110110110110110311111101110111101010011111
1110011111111111101111101111111111110111111111011011111111111110101301111111111101101111111011111001101111111111111110011111011101110311111101101111111111111101
1110110111011111111111011111110110111001101011111111101110011011111301111111111111111101111011110111111100110011011111111111101111101311111111111111001111110111
1110111111111111011111111111111111010010111111111010111111101101101311011101001101111101111111110011111111000111111111101111100111111311011011001011111111111110
1111101111110010111011111111111111010110101110110110111011101111011311110111111011110111000110110101111011111011111111011111010101111310111101111111111111111111
0111111011111101101111111101111111111110101111111111111101110111111311111011100111110111111110111100111111110010111011111111111101001301111111111011000110111111
1011001111101111110101011010101011011011110011111010111101111011011311111111111011110111111111011111111111111111111111110010111111010301111100111111111011101110
1111111011001111111111111011000110110001011111111111111101111111100311111111001101111111111101111111111110101111111101111100100111011311111111111111111111101101
1101111111011011101110111001111111111111111111110111011111111111111311111110101111110111111111111111110111111111110111111111111110111311111111110100100111011011
1111111111111110110010111111111101111110101111111101110111111111011311111011111111111110111101111111111110111111111110111110111111111311010111100001111111011011
1111111111011111110011111001101011111111111110100101111111001111010311101111111011011100111111111111101111101010110111100110111111111311111101111111111111110111
1100101101011011011111111111100110111001111100011111111111110110111311111111110011111111111110110111111111100100111111010111010111111301101101111111111111011001
1110111101111111111111110111100111101110011110111111101011111110111311111111110011101011111010111010111011111001111111111111101111111311110111111100101011110001
1111100111111010111011010011111011100111101101111101101101101011111301110111111111111101000111111111100110011101111111010111110101111301011111110101111100111111
1110111111111111110110111111111111111011110111111001111111101101111111111101111111111011111100000111111111111010111101111111111101101110111111100011110111111010
0011101111111111111111101101111110111111101111111100110011111111100100111111011001101111111111111010011111111101110010111111111111111111101101111111111111101111
1001111111111111111110110111101111111101111011010111111111111101111111111101011111000101111110001111110111111111110011001111110011111001101001111011101111111110
1111111111111111111111011011101111110101111111111011111111111101101111111111010110111111111111011110011110111111111111101101111111111111110011111100111111111111
0111011111111110101111100110111000111111011111110100101111011110111110111111111111111110111101101011111111011111111111001111111011110101111011000101111100111100
1111001111110111101111111101111101100111111011111111111011100101111111101110011111101111101110110111111111111101101101111111111111111111111111111111111111001111
1111111011111001110111111110111011111111111110111111111111010111110110111110111111110111111111111111111111011111111110011011101111111011111111011111011111111011
1111010101110111111110110111111111111110111011011111111111111101011111011100111110111010110110111101110111111111111111011110111110111101111111111111101001100111
1010011111111111111111111111111001010111101111101110111011110111111011111111101111111101011110111011001111111011010011010101101110101111110111101010111111111110
0111111111111111110111111111111100111101100111000101110111101011111100111111111111111111111111111110101101111111111110111011111111110111011111001010111111101111
1110110111111111111111111111111110001111111111010110101111111101110111011001111111111111001111111101111111111110111110110111101110111111010110010110010111010110
1101101011011111111111111111111111011011101011111111011111011111100110111111111111011111111111011011111111111111111111111111111011111111111111110110111111111011
1111111110111111111101111110111111101011001111011011111111111110111011111110110110111111101101111110110111111111111111111110110111011111110111011011111111111111
0110110001111111011110111010111111111111110011111110011111111111011111011111110101111101111111111101111110010111111110101111101101101111111111111111101111110110
0011111111111111101111111111111000111110011111011101101110111111111111111111001110010110111110011110111011111010011111110111111111010101111100111111111111011111
0111111101101111111011111111111111111111111011011111111101111011111111101101101111111111101111101111101111011001111110111111011011111111111111001010110110111101
1110111111101111111011111011111111111011111111111111111111111101011101111111000101101111111101111111011111111111110111111110100111111100111111101110011111111111
0111111011111110101111111111101111111111111111101111100011111011011111010101111111111111111111011111111000111110111011101011111111111111101111011101111111011111
1111111110100111111101010111111011111111111111111001110110111111101111111110101111101011011111111001011111111011111111111011011111101111111111111111111101111011
1111101111111111110011111111111111001110111110111101011111101011101111111111111111011111111100111101111101111111102110212111201121101211111110100111111110011111
1001111110111111111010010101110111101101110101011111111111111011111111111111111110111111111111111111111111111111011100002121111222001122122111111011111111011101
1011000111111111011111111110011111111111111111011111111101111111111111111001111111111110111011101011111010111111222100012000001011212021010243333333333333333333
1111111010011100111101110011111111111111111101111101111111110111111111011101011110001111101111100111010111011001111212211022020221201211111101110111110111110110
0111111100110101111100111010110111111011111111101111110111011011101101101011111110010101000101110111111110111111112100210121022222120200201212111101111111111101
1111011111110111110111111011111111101101111111111101010101111101110111110111111110111111110011111011111111110111202211001222211211202211121222011101111111110111
1111100111111111110111111110111101111110001011111011101111011011101111110111101110011111111111011111101111111111120221110222022110221210112210111111110101111110
0011111111111111101111110011111111111101100111011001101110100101011100111111111101100011111100110111101011111111011121202121121010221100111121201101111100110111
1110101111101101111111111101111111111111110101011111010111011110111111101111111011001011011001101111010111111111020210101222021122011112200212011111111111011111
1011100101111111111011111111111111111111111101010011111001111111111111111110111111001111111111111101111111001111222222121221211101202212002212101111101111111111
1101111111111111111100111110111110111101100100101111111111011111111111111000011011110111110111110111001111101101122111222110121111222121112111110111111111110101
1011110011111001011111111111111111011110110101111101111111111110111111011111110110111110111101011111111010110111102212222122110122022021221121111111110111011011
0111111111101111011111011111100011111110111111011111011101110111111011110111011011101100101111111110111011111111201212120212010210022221121101100101111110111111
1101011111111111111101111100110111111111111211122211022212220121111211221011111101111111110110111001111100110110022120020012102120101111111121011111111101110011
1101111111010111110111111111111101101101111010122122102122122202002222021010021211122112000020211111111011110011112220021202110220110212122011211111101111010111
1110011111011111111100111101010111111111110210222211211220221122112202121222221121202011222221201101111011111111221210022121221212212120220222022101201111111111
1111011010111111111111111111011111111111111211112121101102112211000220222210122200202111012111101111111110111111010202212221221122121002221221001222020111111111
0100111111101101101111110111111111101010111121211121210210002111221022222101100222111121111212001001011110111110001002122220101021222222110222210120221111111111
1101111011100101001110111111111111111011112112111201100020111220210122022010101222222222000112111010111101111101101201222202210221211201222212222201111011111111
0111011011111111111111111111101100011111111121112201212111202111200212022110102122001111012121110011111010111110011110122221220022202212122102212011201111110111
1111010111111100111100100111111011111111112222122020221222102211002022020112221221222111021222101011111111111111122200102220110222220122221121220112121111100110
1111011111111111111011111111111111111111111202012022220111210122121212022011221202002221002100211111111011111111222112202222222211200022002210212122121111111111
1111111111011111110110011001111101011101002022121202210021101220222222212112200211222120022102111010010111110011211212120220120222212222201010012212021011111011
1111111111111111101110110001010111111111111110221112221210122210022211221200211002120001212122011111101111011111001211212222122102122221022020201012121001111111
1111011111111111111111011111111101111111111201201011111221012022222012102212222012202012111222011011011111101101021120110022222222202222220120121220121111101001
1111110001111111111111101101011101111001110122201222222010020200201212201220202211211201101222110001110111100111111200010211212212121222220121222021201111101111
1011111111111111111111011111111111101101111212212111211122200201122222202120221121212110102110110111011111101111121212212122220222220220122202101112211111111101
1111111011101111011011111101111111111011112111111111210110211121002211111121122222122222220010221112111222111111112201101122022222010210110222012122221111111101
1011101111011101101110001111001011111111112110111112122002101122222220112101121210221122222222202002122012111101211212122211122021022222202222211122221111111111
1011111110111111111011111111111111101111012222202221201122121211112210022112221212222202221222121222002112101111102120222202101102010210020212221201120100111110
1101111111111111111011111110100111111010111211122211002111122111212212020112210022121222122012222110112121111111120111112022211222111221222222211002211011110111
1111111011011111110111011111111111011110111200222102111201201112012122121122222212220200001120012111012112011111011111110101222122221111201221110221101111111011
1111111111011110111011101111111111111011111111120112112211210122012022221112220222212222222212121111011212111110111001121120120112211122121212120020100101111111
0100111111111010101111110101111101001011001211011020211122011222220222120012122212222112022202011201112221101001101110121220112010222222222122220222200222011111
1111110111111111111111011111110111110110111102122121002212122012222001022122102221021122212002022011221110101010111110112112122220222201221122202002212021210101
1111111111111000011101001111111111010111011222210110212011221022122012222121212102210221202002211111021221111111111111120122220100121220012212002122220120200111
1110011001111111111111110111011011101111101212111122121111021221122022022121221202202221020202211012020120111111101111120221122120220120200221022020221211221101
1111111111111111111100111111111111111111112101221121210120221112222222020202122122222122222112212222112021010111011111112111021222022200122221122222220112001111
1111110111111011111111101001100001101000110101011112212121112202220222120121021022202122222222220022102122110111110111102111210222022202122221122222121220211110
0111101011110111111101111111111011110111111001110212211221102212222222222200221221220222022212202221202221111101110111021021200210212212020022211122021102111101
1111101101111111101111111111111111111111112011112110021021210222200222222121221220010020212122022111111111011111111111121202121222220102202200122222021211100011
1110111111111111111111111110111111101101111211112011112220222000022222012012201222222212022222101021221010111111111111121211022202120202222202122200222210011011
1110101111011111101110101110101111111100012211022211122002022020022201222012222221221212220222210120221120110111110111110022222220220122212112222220001211021111
1111111111011111111011111111111011111111012001012011022111112010121122121220222212122021221221221211212211111110111101021002212221002112022221222200201201111011
0011010111110010111111111111010111011111100111101111111100111101211222120002022210022020222122122122022211111111001111121100120222220222111200012222222111121101
1110100111011011110110110110111111001111111111111101111001111101111111111011021200111122000202121011210121001111110100122222122122122212120211122102222202221111
1010111111111101111101110111111111101001111100111111011110111111111110111110101212220220000221221211210121111111111111101110002112211222100012112020122121211111
1111111101111111111111111111111101111111111111111011111110111111111111111111220221111121212112212121111122011101111011101111112122221212100101121101222222221101
0110111111111110101110111110111101111111111111011111001111111111111001111011102222202011221111020210121212011111111111111010120121121112222212121102121211120111
1111110110011111111101111111011111111111111111111111010001101101011101111000212212100211202212021112012102011011011111111111110111101221120121102121212200201101
1111110111111111111111101110100111111111111111110011101111111011010111101110220120110212202022201221110120111110111111100111112102211202102111202222111111211001
1111110111111110111111101111110010111111111111110011111111111100011111111111202020212100212021111212222022111111111101010111012222121121222202211020102122111110
1111011110111111101111101111111100111011101111111111111111011111101111101112211201222221211122001212112220111111111011111111111112211211112211210111201211120101
1010011001111111111110001001111110011101011111011110110111110111111111011111100212021211122020122111101222111111111101111111111022211101011111221122212222211111
1110011111111111010101110111111110011010011000111110101101111110110011011101202022011122121221021211222101111111111110111111100212212200010201111221210112001101
1001101111101101111010111110111111011100111111011011011111110111111111111102012102112112022201211212112211111101011111100111122202222101122121011012202112220001
1101110111111011001111110111110110101011111110111000110110101111110111011110120102222220121212221212222211111011111101111100122211202201202102212122111212101111
1111111001111111111101111111111010011010111001110101111111101101011111101102100022011000112220110221100221111111101011101111011020110101122102112212212201121111
1111101011101111101111101101110111101011110111111111111111101111111111101111011011111110111111111101011110110111111110011111011201221111112211121120021202210111
1101111010010111111010111111111111111111110111110111100011111111111101110111111111011101011111101111001111111010011111111110111221122102111111212102102212001220
1110111001111011101101111001111101111110111111111111111110011111101111111111111110011011111111110111011111111111100110111111122102110012011101222121222202121212
0111011111011111111101111101111110111011110111111011101111111001101111111010011110111011111110111111010111101110111111111110002122110110221122121022022212010212
1010111111111111111111110110111111111111111011001111111111111011111111111110011112201221112202102121110122101111111111111001121221212211102121220200022222022212
1111111111001111101111111111111111111101111110010111011111111010111111111111111100221211102122220222211101212110111011011111111222022101202102222022022220121111
1111110101110101110111111111111111111110111101011110111111011111111111011111112221101221112122112111222211112110111111101111111111111101011111022200202011111010
1101111111111101011111111011100010110111111010111000100111110110111101101111102211012111202022222112122212211111111101110011111111011100111111111112012121212210
1111011110111110111111111111111101111111110111111101111011101110111111111111101020222212021222212122112212002011111111011111101111101010011101120220222001111021
0110111110111111111101001011011011110110110111101111110011110011111110001111101211211212002120222111221121112111111111101011111011111111101110101211211210111212
1111111101011111111111111111110101111101111111111111100111111110110011001111111122122111212220201210121122001111011111101111011110011111110011021212111220221220
1111011111101011011101111101101111110011111111111111011100001111110011111110111200000012222110121120221102110101011111111111111111101111011011012121121122212222
1111110110011110110111111011111111111111111111011110111100111111110110011101112102121111221212211221220202202011101110001111111111110111100111111012102121121111
1111101110111101101011110111010110011100111111101111101101101111000111110110112020111211022022202100101122102111101011111110111101111111111111112100111220122021
0111110011111011111111111101011111101110111111111111111111111111110110111110112121100122111111111122220102121011111111100101000111111111111010122110100121122112
1111010110111111101011111101100011111010010110111001101111111111111100101011111222110222112222112111121110112111111011111010111110111111011111122101211102111101
1111101111101111111101111111111101111110100101111001110111111111110111111111111110211001210221020002221112111111011110111110100010100111101111101021221101202121
1111111111110111111001111101101111110001111011111110101111101111111010011110112111121201121221112021221210221111101111111101111011111111101111111110210002112211
1010111101111111110110111011111101110111111111011100101111011011011101101111112120111102212221220212101110210111100111111111111111101111111110110212110112100120
1111111111111011101010101111101111111111111111111001110110111001011110111111111122011212122201111102002112121111010001111111111111111111011111112121122221121120
1111110111111110111111111111101111101111011011111111111111111011110101110011111212212202221102212222111121222011010111111110111101111101011133344444444433444443
1111111111101101111001101111111111111111111101111001111111111111111111111111112012111212111011211020220121110011111011111111111101111111111100112221012001212122
0110101111111011111101111100111110110011111101111101110111101101011111001111111120121102111110111120202112111111111101111111011110111101100111101210121121220110
